#####E######
#   #      #
# # # #### #
### #    # #
#    ### # #
#### # # # #
#  # # # # #
## # # # # #
#        # #
###### ### #
#      #   #
#########S##